27 3 16 19
2 2 2 2 2 2 2 2 2 2 2 2 2 2 2 2 2 2 2 2 2 2 2 2 2 2 2 2 2 2 
2 11 3 3 3 3 3 3 3 3 3 3 12 3 3 3 3 3 2 3 3 3 2 3 23 3 3 3 13 2 
2 3 3 3 3 3 3 3 3 3 3 3 3 3 3 3 3 3 2 3 3 3 2 14 2 3 3 3 3 2 
2 3 3 3 3 3 3 3 3 3 3 3 3 3 3 3 3 3 2 3 3 3 2 3 23 3 3 0 3 2 
2 3 3 3 3 3 3 3 3 3 3 3 3 3 3 3 3 3 24 3 3 3 3 24 2 2 2 2 2 2 
2 3 3 3 3 3 3 3 3 3 3 3 3 3 3 3 3 3 2 3 3 3 3 3 3 3 3 3 3 2 
2 3 3 3 3 3 3 3 3 3 3 3 3 3 3 3 3 3 2 3 3 3 3 3 3 3 3 3 3 2 
2 3 3 3 3 3 3 3 3 3 3 3 3 3 3 3 3 2 2 2 2 3 2 3 3 3 3 3 3 2 
2 2 2 2 2 2 2 2 2 2 3 2 3 2 2 2 2 10 3 3 3 2 3 2 2 2 2 2 2 2 
2 3 3 3 3 3 3 2 3 3 3 3 3 3 2 3 3 3 3 3 3 3 3 3 2 3 3 3 3 2 
2 3 3 3 3 3 3 3 3 3 3 3 3 3 2 3 3 3 3 3 3 3 3 3 3 2 3 3 3 2 
2 3 3 2 3 3 3 2 3 3 2 2 2 2 2 3 3 3 3 3 3 3 3 3 3 2 3 3 3 2 
2 2 3 2 2 2 2 2 2 2 3 2 3 3 2 3 3 3 3 3 3 3 3 3 3 2 3 3 3 2 
2 3 21 3 3 3 3 3 3 3 3 2 3 3 3 3 3 3 3 3 3 3 3 3 3 2 3 3 3 2 
2 3 3 3 3 3 3 3 3 3 3 2 3 3 2 3 3 3 3 3 3 3 3 3 3 2 3 3 3 2 
2 3 3 3 3 3 3 3 3 3 3 2 3 3 2 2 2 2 2 2 3 3 3 3 3 3 3 3 3 2 
2 2 2 2 2 2 2 22 2 2 2 2 3 3 2 3 3 3 20 3 2 2 2 2 2 2 2 3 3 2 
2 3 3 3 3 3 3 3 3 2 3 2 3 3 2 3 3 3 2 3 3 3 3 3 3 2 3 3 3 2 
2 3 3 3 3 3 3 3 3 2 3 3 3 3 2 3 3 3 2 3 2 3 3 2 3 2 3 3 3 2 
2 3 2 3 2 2 2 2 2 2 3 2 3 3 2 3 1 3 3 2 2 3 3 3 2 2 3 3 3 2 
2 3 3 3 3 2 3 3 3 3 3 2 3 3 2 3 3 3 3 3 3 2 2 3 3 2 3 3 3 2 
2 3 3 3 3 2 3 3 3 3 3 2 2 2 2 3 3 3 3 3 3 3 2 3 3 3 3 3 3 2 
2 3 3 3 3 23 3 3 3 3 3 2 3 3 3 3 3 3 3 3 3 3 2 2 3 3 3 3 3 2 
2 20 3 3 3 2 3 3 3 3 3 2 3 3 3 3 3 3 3 3 3 3 3 3 2 3 3 3 3 2 
2 2 2 2 2 2 2 2 2 2 2 2 2 2 2 2 2 2 2 2 2 2 2 2 2 2 2 2 2 2 
